 -----------------------
|     |     | W   |     |
| G   |     |     |     |
 -----------------------
|     |     |     | P   |
|     |     |     |     |
 -----------------------
|     |     |     |     |
|     |     |     |     |
 -----------------------
|     |     | P   |     |
|   > |     |     |     |
 -----------------------
