 -----------------------
|     | P   |     |     |
|     |     | G   |     |
 -----------------------
|     |     |     |     |
|     |     |     |     |
 -----------------------
|     | P   |     | W   |
|     |     |     |     |
 -----------------------
|     |     |     |     |
|     |     |   > |     |
 -----------------------
