 -----------------------
|     |     |     |     |
|     |     | G   |     |
 -----------------------
| P   |     |     |     |
|     |     |     |     |
 -----------------------
| P   |     |     | P   |
|     |     |     |     |
 -----------------------
|     |     |     |   W |
|     |   A |     |     |
 -----------------------
